AARÓN	m

ABEL	m

ABIGAÍL	f

ADALBERTO	m

ADÁN	m

ADELA	f

ADELAIDA	f

ADELIA	f

ADELINA	f

ADELITA	f

ADOLFITO	m

ADOLFO	m

ADORA	f

ADORACIÓN	f

ADRIÁN	m

ADRIANA	f

ÁFRICA	f

AGAPITO	m

AGATA	f

ÁGUEDA	f

AGUSTÍN	m

AGUSTINA	f

ALBA (1)	f

ALBERTO	m

ALE	m

ALEJANDRA	f

ALEJANDRO	m

ALEJO	m

ALEXANDRA	f

ALFONSO	m

ALFREDO	m

ALICIA	f

ALITA	f

ALMA	f

ALMUDENA	f
ALONDRA	f

ALONSO	m

ÁLVARO	m

AMADA	f

AMADO	m

AMALIA	f

AMANCIO	m

AMANDA	f

AMANDO	m

AMARANTA	f

AMARILIS	f

AMAYA	f

ÁMBAR	f

AMBROSIO	m

AMELIA	f

AMÉRICA	f

AMÉRICO	m

AMÍLCAR	m

AMPARO	f

ANA	f

ANABEL	f

ANACLETO	m

ANASTASIA	f

ANASTASIO	m

ANDRÉS	m

ÁNGEL	m

ÁNGELA	f

ANGÉLICA	f

ANGELINA	f

ANGELINO	m

ANGELITA	f

ANÍBAL	m

ANITA	f

ANSELMA	f

ANSELMO	m

ANTONIA	f

ANTONIO	m

ANUNCIACIÓN	f

APOLINAR	m

ARACELI	f

ARACELIS	f

ARACELY	f

ARCELIA	f

ARIADNA	f

ARISTIDES	m

ARMANDO	m

ARMIDA	f

ARSENIO	m

ARTURO	m

ASCENSIÓN	f

ASDRUBAL	m

ASUN	f

ASUNCIÓN	f

ATILIO	m

AUGUSTO	m

AURELIANO	m

AURELIO	m

AURORA	f

AZENETH	f

AZUCENA	f
